25,50
##################################################
#                                                #
#                                                #
#                                                #
#                                                #
#                                                #
#        ##################################      #
#                                                #
#                                                #
#                                                #
#                                                #
#                                                #
#                                                #
#                                                #
#                                                #
#                                                #
#                                                #
#                                                #
#                                                #
#                                                #
#                                                #
#                                                #
#                                                #
#                                                #
##################################################
