25,50
##################################################
#                                                #
#                                                #
#                                                #
#                                                #
#                                                #
#       ########                 #########       #
#       #                                #       #
#       #                                #       #
#       #                                #       #
#       #                                #       #
#       #                                #       #
#       #                                #       #
#       #                                #       #
#       #                                #       #
#       #                                #       #
#       #                                #       #
#       ########                  ########       #
#                                                #
#                                                #
#                                                #
#                                                #
#                                                #
#                                                #
##################################################
