##################################################
#                                                #
#                                                #
#                                                #
#                                                #
#          ####                                  #
#                                                #
#             ####                               #
#                                                #
#                ####                            #
#                                                #
#                   ####                         #
#                                                #
#                                                #
#                                                #
#                                                #
#                                                #
#                                                #
#                                                #
#                                                #
#                                                #
#                                                #
#                                                #
#                                                #
##################################################
